11111111111111111111
1P0000000000000000E1
10011100001111110001
1C000100010000000001
100000100010000000C1
10000011101000011001
10010000000000001001
1C000001000001111101
10000001000000000001
11111111111111111111
