11111111111111111111
1P0000000000000000E1
11111100001111110001
1C000100010000000001
100000100010000000C1
10000011111000000001
10000000000000000001
1C000000000001111101
100000000000000000P1
11111111111111111111
