11111111111111111111
1P0000000000000000E1
11111100001111110001
1C000100010000000001
100000100010000000C1
10110011111000000001
11001000000000000001
1C000110000001111101
10000001000000000001
11111111111111111111
